####### #######
######  #######
#####  ########
##### #########
#####      ####
########## ####
##########  ###
########### ###
